version 4
#
Block -1 -1 0 7 7 0 0 0.8 1 0 0 0 0 0 0 0
	Ref 5 2 1 0 0 0 0 0 -1 0 0 0 0 0 0
	Ref 5 3 1 0 0 0 0 0 -1 0 0 0 0 0 0
	Ref 5 4 1 0 0 0 0 0 -1 0 0 0 0 0 0
	Wall 0 0 0 0 0
	Wall 0 1 0 0 0
	Wall 0 2 0 0 0
	Wall 0 3 0 0 0
	Wall 0 4 0 0 0
	Wall 0 5 0 0 0
	Wall 0 6 0 0 0
	Wall 1 0 0 0 0
	Wall 1 2 0 0 0
	Wall 1 6 0 0 0
	Wall 2 0 0 0 0
	Wall 2 6 0 0 0
	Wall 3 0 0 0 0
	Wall 3 1 0 0 0
	Wall 3 6 0 0 0
	Wall 4 0 0 0 0
	Wall 4 6 0 0 0
	Wall 5 0 0 0 0
	Wall 5 1 0 0 0
	Wall 5 5 0 0 0
	Wall 5 6 0 0 0
	Wall 6 0 0 0 0
	Wall 6 1 0 0 0
	Wall 6 2 0 0 0
	Wall 6 3 0 0 0
	Wall 6 4 0 0 0
	Wall 6 5 0 0 0
	Wall 6 6 0 0 0
	Block 1 1 1 1 1 0.9 1 0.7 1 0 1 1 0 0 0 0
	Block 2 1 2 5 5 0.4 0.8 1 1 0 0 0 0 0 0 0
		Wall 0 0 0 0 0
		Wall 0 1 0 0 0
		Wall 0 2 0 0 0
		Wall 0 3 0 0 0
		Wall 0 4 0 0 0
		Wall 1 0 0 0 0
		Wall 1 1 0 0 0
		Wall 2 0 0 0 0
		Wall 2 1 0 0 0
		Wall 2 3 0 0 0
		Wall 2 4 0 0 0
		Wall 3 3 0 0 0
		Wall 3 4 0 0 0
		Wall 4 0 0 0 0
		Wall 4 1 0 0 0
		Wall 4 2 0 0 0
		Wall 4 3 0 0 0
		Wall 4 4 0 0 0
	Block 4 1 3 5 5 0.4 0.8 1 1 0 0 0 0 0 0 0
		Wall 0 0 0 0 0
		Wall 0 1 0 0 0
		Wall 0 2 0 0 0
		Wall 0 3 0 0 0
		Wall 0 4 0 0 0
		Wall 1 0 0 0 0
		Wall 1 1 0 0 0
		Wall 1 2 0 0 0
		Wall 1 3 0 0 0
		Wall 1 4 0 0 0
		Wall 2 0 0 0 0
		Wall 2 1 0 0 0
		Wall 2 2 0 0 0
		Wall 2 3 0 0 0
		Wall 2 4 0 0 0
		Wall 3 0 0 0 0
		Wall 3 1 0 0 0
		Wall 3 2 0 0 0
		Wall 4 0 0 0 0
		Wall 4 1 0 0 0
		Wall 4 2 0 0 0
		Wall 4 3 0 0 0
		Wall 4 4 0 0 0
		Floor 3 3 PlayerButton
	Block 4 2 4 5 5 0.4 0.8 1 1 0 0 0 0 0 0 0
		Wall 0 0 0 0 0
		Wall 0 1 0 0 0
		Wall 0 2 0 0 0
		Wall 0 3 0 0 0
		Wall 0 4 0 0 0
		Wall 2 0 0 0 0
		Wall 2 1 0 0 0
		Wall 2 2 0 0 0
		Wall 2 3 0 0 0
		Wall 2 4 0 0 0
		Wall 3 0 0 0 0
		Wall 3 1 0 0 0
		Wall 3 2 0 0 0
		Wall 3 3 0 0 0
		Wall 3 4 0 0 0
		Wall 4 0 0 0 0
		Wall 4 1 0 0 0
		Wall 4 2 0 0 0
		Wall 4 3 0 0 0
		Wall 4 4 0 0 0
	Block 4 3 5 5 5 0.4 0.8 1 1 0 0 0 0 0 0 0
		Wall 0 0 0 0 0
		Wall 0 1 0 0 0
		Wall 0 2 0 0 0
		Wall 0 3 0 0 0
		Wall 0 4 0 0 0
		Wall 1 0 0 0 0
		Wall 1 1 0 0 0
		Wall 1 2 0 0 0
		Wall 1 3 0 0 0
		Wall 1 4 0 0 0
		Wall 2 0 0 0 0
		Wall 2 1 0 0 0
		Wall 2 2 0 0 0
		Wall 2 3 0 0 0
		Wall 2 4 0 0 0
		Wall 4 0 0 0 0
		Wall 4 1 0 0 0
		Wall 4 2 0 0 0
		Wall 4 3 0 0 0
		Wall 4 4 0 0 0
	Block 4 4 6 5 5 0.4 0.8 1 1 0 0 0 0 0 0 0
		Wall 0 0 0 0 0
		Wall 0 1 0 0 0
		Wall 0 2 0 0 0
		Wall 0 3 0 0 0
		Wall 0 4 0 0 0
		Wall 1 3 0 0 0
		Wall 1 4 0 0 0
		Wall 2 0 0 0 0
		Wall 2 1 0 0 0
		Wall 2 3 0 0 0
		Wall 2 4 0 0 0
		Wall 3 0 0 0 0
		Wall 3 1 0 0 0
		Wall 4 0 0 0 0
		Wall 4 1 0 0 0
		Wall 4 2 0 0 0
		Wall 4 3 0 0 0
		Wall 4 4 0 0 0
	Block 4 5 7 5 5 0.4 0.8 1 1 0 0 0 0 0 0 0
		Wall 0 0 0 0 0
		Wall 0 1 0 0 0
		Wall 0 3 0 0 0
		Wall 0 4 0 0 0
		Wall 1 3 0 0 0
		Wall 1 4 0 0 0
		Wall 2 0 0 0 0
		Wall 2 1 0 0 0
		Wall 2 2 0 0 0
		Wall 2 3 0 0 0
		Wall 2 4 0 0 0
		Wall 3 0 0 0 0
		Wall 3 1 0 0 0
		Wall 3 2 0 0 0
		Wall 3 3 0 0 0
		Wall 3 4 0 0 0
		Wall 4 0 0 0 0
		Wall 4 1 0 0 0
		Wall 4 2 0 0 0
		Wall 4 3 0 0 0
		Wall 4 4 0 0 0
