version 4
#
Block -1 -1 0 7 7 0.6 0.8 1 1 0 0 0 0 0 0 0
	Ref 2 4 0 1 0 0 0 0 -1 0 0 0 0 0 0
	Wall 0 0 0 0 0
	Wall 0 1 0 0 0
	Wall 0 2 0 0 0
	Wall 0 3 0 0 0
	Wall 0 4 0 0 0
	Wall 0 5 0 0 0
	Wall 0 6 0 0 0
	Wall 1 0 0 0 0
	Wall 1 6 0 0 0
	Wall 2 0 0 0 0
	Wall 2 6 0 0 0
	Wall 3 0 0 0 0
	Wall 3 6 0 0 0
	Wall 4 0 0 0 0
	Wall 4 6 0 0 0
	Wall 5 0 0 0 0
	Wall 5 6 0 0 0
	Wall 6 0 0 0 0
	Wall 6 1 0 0 0
	Wall 6 2 0 0 0
	Wall 6 4 0 0 0
	Wall 6 5 0 0 0
	Wall 6 6 0 0 0
	Block 2 2 1 5 5 0.1 0.8 1 1 0 0 0 0 0 0 0
		Wall 0 0 0 0 0
		Wall 0 1 0 0 0
		Wall 0 2 0 0 0
		Wall 0 3 0 0 0
		Wall 0 4 0 0 0
		Wall 1 0 0 0 0
		Wall 1 4 0 0 0
		Wall 2 0 0 0 0
		Wall 2 4 0 0 0
		Wall 3 0 0 0 0
		Wall 3 4 0 0 0
		Wall 4 0 0 0 0
		Wall 4 1 0 0 0
		Wall 4 2 0 0 0
		Wall 4 3 0 0 0
		Wall 4 4 0 0 0
	Block 3 3 2 7 7 0.9 1 0.7 1 0 1 1 0 0 0 0
		Wall 0 0 0 0 0
		Wall 0 1 0 0 0
		Wall 0 2 0 0 0
		Wall 0 3 0 0 0
		Wall 0 4 0 0 0
		Wall 0 5 0 0 0
		Wall 0 6 0 0 0
		Wall 1 0 0 0 0
		Wall 1 4 0 0 0
		Wall 1 5 0 0 0
		Wall 1 6 0 0 0
		Wall 2 0 0 0 0
		Wall 2 4 0 0 0
		Wall 2 5 0 0 0
		Wall 2 6 0 0 0
		Wall 3 0 0 0 0
		Wall 4 0 0 0 0
		Wall 4 4 0 0 0
		Wall 4 5 0 0 0
		Wall 4 6 0 0 0
		Wall 5 0 0 0 0
		Wall 5 4 0 0 0
		Wall 5 5 0 0 0
		Wall 5 6 0 0 0
		Wall 6 0 0 0 0
		Wall 6 1 0 0 0
		Wall 6 2 0 0 0
		Wall 6 3 0 0 0
		Wall 6 4 0 0 0
		Wall 6 5 0 0 0
		Wall 6 6 0 0 0
		Floor 1 1 PlayerButton
		Floor 5 3 Button
	Block 4 2 3 5 5 0.1 0.8 1 1 0 0 0 0 0 0 0
		Wall 0 0 0 0 0
		Wall 0 1 0 0 0
		Wall 0 2 0 0 0
		Wall 0 3 0 0 0
		Wall 0 4 0 0 0
		Wall 1 0 0 0 0
		Wall 1 4 0 0 0
		Wall 2 0 0 0 0
		Wall 2 4 0 0 0
		Wall 3 0 0 0 0
		Wall 3 4 0 0 0
		Wall 4 0 0 0 0
		Wall 4 1 0 0 0
		Wall 4 2 0 0 0
		Wall 4 3 0 0 0
		Wall 4 4 0 0 0
	Block 4 4 4 5 5 0.1 0.8 1 1 0 0 0 0 0 0 0
		Wall 0 0 0 0 0
		Wall 0 1 0 0 0
		Wall 0 2 0 0 0
		Wall 0 3 0 0 0
		Wall 0 4 0 0 0
		Wall 1 0 0 0 0
		Wall 1 4 0 0 0
		Wall 2 0 0 0 0
		Wall 2 4 0 0 0
		Wall 3 0 0 0 0
		Wall 3 4 0 0 0
		Wall 4 0 0 0 0
		Wall 4 1 0 0 0
		Wall 4 2 0 0 0
		Wall 4 3 0 0 0
		Wall 4 4 0 0 0
