version 4
#
Block -1 -1 0 11 11 0 0 0.8 1 0 0 0 0 0 0 0
	Wall 0 0 0 0 0
	Wall 0 1 0 0 0
	Wall 0 2 0 0 0
	Wall 0 3 0 0 0
	Wall 0 4 0 0 0
	Wall 0 5 0 0 0
	Wall 0 6 0 0 0
	Wall 0 7 0 0 0
	Wall 0 8 0 0 0
	Wall 0 9 0 0 0
	Wall 0 10 0 0 0
	Wall 1 0 0 0 0
	Wall 1 7 0 0 0
	Wall 1 10 0 0 0
	Wall 2 0 0 0 0
	Wall 2 10 0 0 0
	Wall 3 0 0 0 0
	Wall 3 7 0 0 0
	Wall 3 8 0 0 0
	Wall 3 9 0 0 0
	Wall 3 10 0 0 0
	Wall 4 0 0 0 0
	Wall 4 7 0 0 0
	Wall 4 8 0 0 0
	Wall 4 9 0 0 0
	Wall 4 10 0 0 0
	Wall 5 0 0 0 0
	Wall 5 10 0 0 0
	Wall 6 0 0 0 0
	Wall 6 7 0 0 0
	Wall 6 10 0 0 0
	Wall 7 0 0 0 0
	Wall 7 1 0 0 0
	Wall 7 3 0 0 0
	Wall 7 4 0 0 0
	Wall 7 6 0 0 0
	Wall 7 7 0 0 0
	Wall 7 8 0 0 0
	Wall 7 9 0 0 0
	Wall 7 10 0 0 0
	Wall 8 0 0 0 0
	Wall 8 1 0 0 0
	Wall 8 4 0 0 0
	Wall 8 7 0 0 0
	Wall 8 8 0 0 0
	Wall 8 9 0 0 0
	Wall 8 10 0 0 0
	Wall 9 0 0 0 0
	Wall 9 1 0 0 0
	Wall 9 4 0 0 0
	Wall 9 7 0 0 0
	Wall 9 8 0 0 0
	Wall 9 9 0 0 0
	Wall 9 10 0 0 0
	Wall 10 0 0 0 0
	Wall 10 1 0 0 0
	Wall 10 2 0 0 0
	Wall 10 3 0 0 0
	Wall 10 4 0 0 0
	Wall 10 5 0 0 0
	Wall 10 6 0 0 0
	Wall 10 7 0 0 0
	Wall 10 8 0 0 0
	Wall 10 9 0 0 0
	Wall 10 10 0 0 0
	Floor 1 1 PlayerButton
	Floor 1 9 Button
	Floor 6 9 Button
	Floor 9 3 Button
	Floor 9 6 Button
	Block 2 2 2 5 5 0.9 1 0.7 1 1 1 1 0 0 0 0
	Block 3 3 3 7 7 0.6 0.8 1 1 0 0 1 0 0 0 0
		Wall 0 0 0 0 0
		Wall 0 1 0 0 0
		Wall 0 2 0 0 0
		Wall 0 3 0 0 0
		Wall 0 4 0 0 0
		Wall 0 5 0 0 0
		Wall 0 6 0 0 0
		Wall 1 0 0 0 0
		Wall 1 1 0 0 0
		Wall 1 2 0 0 0
		Wall 1 3 0 0 0
		Wall 1 4 0 0 0
		Wall 1 5 0 0 0
		Wall 1 6 0 0 0
		Wall 2 0 0 0 0
		Wall 2 1 0 0 0
		Wall 2 2 0 0 0
		Wall 2 3 0 0 0
		Wall 2 4 0 0 0
		Wall 2 5 0 0 0
		Wall 2 6 0 0 0
		Wall 3 2 0 0 0
		Wall 3 3 0 0 0
		Wall 3 4 0 0 0
		Wall 4 0 0 0 0
		Wall 4 1 0 0 0
		Wall 4 2 0 0 0
		Wall 4 3 0 0 0
		Wall 4 4 0 0 0
		Wall 4 5 0 0 0
		Wall 4 6 0 0 0
		Wall 5 0 0 0 0
		Wall 5 1 0 0 0
		Wall 5 2 0 0 0
		Wall 5 4 0 0 0
		Wall 5 5 0 0 0
		Wall 5 6 0 0 0
		Wall 6 0 0 0 0
		Wall 6 1 0 0 0
		Wall 6 2 0 0 0
		Wall 6 4 0 0 0
		Wall 6 5 0 0 0
		Wall 6 6 0 0 0
	Block 3 5 1 7 7 0.6 0.8 1 1 0 0 1 0 0 0 0
		Wall 0 0 0 0 0
		Wall 0 1 0 0 0
		Wall 0 2 0 0 0
		Wall 0 4 0 0 0
		Wall 0 5 0 0 0
		Wall 0 6 0 0 0
		Wall 1 0 0 0 0
		Wall 1 1 0 0 0
		Wall 1 2 0 0 0
		Wall 1 4 0 0 0
		Wall 1 5 0 0 0
		Wall 1 6 0 0 0
		Wall 2 0 0 0 0
		Wall 2 1 0 0 0
		Wall 2 2 0 0 0
		Wall 2 3 0 0 0
		Wall 2 4 0 0 0
		Wall 2 5 0 0 0
		Wall 2 6 0 0 0
		Wall 3 2 0 0 0
		Wall 3 3 0 0 0
		Wall 3 4 0 0 0
		Wall 3 5 0 0 0
		Wall 3 6 0 0 0
		Wall 4 0 0 0 0
		Wall 4 1 0 0 0
		Wall 4 2 0 0 0
		Wall 4 3 0 0 0
		Wall 4 4 0 0 0
		Wall 4 5 0 0 0
		Wall 4 6 0 0 0
		Wall 5 0 0 0 0
		Wall 5 1 0 0 0
		Wall 5 2 0 0 0
		Wall 5 4 0 0 0
		Wall 5 5 0 0 0
		Wall 5 6 0 0 0
		Wall 6 0 0 0 0
		Wall 6 1 0 0 0
		Wall 6 2 0 0 0
		Wall 6 4 0 0 0
		Wall 6 5 0 0 0
		Wall 6 6 0 0 0
	Block 5 3 4 7 7 0.6 0.8 1 1 0 0 1 0 0 0 0
		Wall 0 0 0 0 0
		Wall 0 1 0 0 0
		Wall 0 2 0 0 0
		Wall 0 4 0 0 0
		Wall 0 5 0 0 0
		Wall 0 6 0 0 0
		Wall 1 0 0 0 0
		Wall 1 1 0 0 0
		Wall 1 2 0 0 0
		Wall 1 4 0 0 0
		Wall 1 5 0 0 0
		Wall 1 6 0 0 0
		Wall 2 0 0 0 0
		Wall 2 1 0 0 0
		Wall 2 2 0 0 0
		Wall 2 3 0 0 0
		Wall 2 4 0 0 0
		Wall 2 5 0 0 0
		Wall 2 6 0 0 0
		Wall 3 2 0 0 0
		Wall 3 3 0 0 0
		Wall 3 4 0 0 0
		Wall 4 0 0 0 0
		Wall 4 1 0 0 0
		Wall 4 2 0 0 0
		Wall 4 3 0 0 0
		Wall 4 4 0 0 0
		Wall 4 5 0 0 0
		Wall 4 6 0 0 0
		Wall 5 0 0 0 0
		Wall 5 1 0 0 0
		Wall 5 2 0 0 0
		Wall 5 3 0 0 0
		Wall 5 4 0 0 0
		Wall 5 5 0 0 0
		Wall 5 6 0 0 0
		Wall 6 0 0 0 0
		Wall 6 1 0 0 0
		Wall 6 2 0 0 0
		Wall 6 3 0 0 0
		Wall 6 4 0 0 0
		Wall 6 5 0 0 0
		Wall 6 6 0 0 0
	Block 5 5 5 7 7 0.6 0.8 1 1 0 0 1 0 0 0 0
		Wall 0 0 0 0 0
		Wall 0 1 0 0 0
		Wall 0 2 0 0 0
		Wall 0 4 0 0 0
		Wall 0 5 0 0 0
		Wall 0 6 0 0 0
		Wall 1 0 0 0 0
		Wall 1 1 0 0 0
		Wall 1 2 0 0 0
		Wall 1 4 0 0 0
		Wall 1 5 0 0 0
		Wall 1 6 0 0 0
		Wall 2 0 0 0 0
		Wall 2 1 0 0 0
		Wall 2 2 0 0 0
		Wall 2 3 0 0 0
		Wall 2 4 0 0 0
		Wall 2 5 0 0 0
		Wall 2 6 0 0 0
		Wall 3 0 0 0 0
		Wall 3 1 0 0 0
		Wall 3 2 0 0 0
		Wall 3 3 0 0 0
		Wall 3 4 0 0 0
		Wall 4 0 0 0 0
		Wall 4 1 0 0 0
		Wall 4 2 0 0 0
		Wall 4 3 0 0 0
		Wall 4 4 0 0 0
		Wall 4 5 0 0 0
		Wall 4 6 0 0 0
		Wall 5 0 0 0 0
		Wall 5 1 0 0 0
		Wall 5 2 0 0 0
		Wall 5 4 0 0 0
		Wall 5 5 0 0 0
		Wall 5 6 0 0 0
		Wall 6 0 0 0 0
		Wall 6 1 0 0 0
		Wall 6 2 0 0 0
		Wall 6 4 0 0 0
		Wall 6 5 0 0 0
		Wall 6 6 0 0 0
